-4        -4        -4        -4        0        5        0        2        5        0        0        -4        -4        -4        -4        
-4        1        -4        0        -4        -4        -4        0        -4        -4        -4        0        -4        1        0    
2        -4        5        -4        0        2        5        -4        0        2        0        -4        0        -4        0        
3        0        -4        0        3        2        -4        5        -4        2        3        0        -4        0        -4    
2        0        -4        3        -4        2        -4        0        -4        2        -4        3        -4        0        -4        
-4        0        -4        0        -4        -4        0        0        0        -4        -4        0        -4        0        3    
3        0        -4        -4        2        -4        1        1        1        -4        2        -4        -4        0        3        
-4        3        5        -4        0        -4        3        2        3        -4        0        -4        0        -4        -4    
-4        3        -4        0        3        2        -4        -4        -4        2        3        0        3        -4        2        
0        -4        -4        3        0        -4        0        -4        5        -4        0        -4        3        -4        2    
5        -4        0        3        -4        5        -4        -4        -4        0        -4        -4        -4        -4        -4        
-4        1        4        -4        -4        -4        0        0        0        -4        3        -4        4        1        -4    
-4        0        0        -4        -4        3        3        -4        3        -4        -4        -4        0        0        -4